7
5/5/
23/1/
23/5/
23/25/
1/30/
15/15/
10/38/
12/12/12/12/12/12/12/12/12/12/12/12/12/12/12/12/12/12/12/12/12/12/12/12/12/12/12/12/12/12/12/12/12/12/12/12/12/12/12/12/
12/00/12/00/00/00/12/00/00/00/12/00/00/00/12/00/00/00/00/00/12/12/12/00/00/00/12/00/00/00/00/00/00/12/00/00/00/00/00/12/
12/00/12/00/12/00/12/00/12/00/12/00/12/00/12/00/12/00/12/00/00/00/00/00/12/00/12/00/12/12/12/12/00/12/00/12/12/12/00/12/
12/00/00/00/12/00/00/00/12/00/12/00/12/00/00/00/12/00/12/00/12/12/12/00/12/00/12/12/12/00/00/00/00/12/00/00/00/00/00/12/
12/00/12/00/00/00/12/12/12/12/12/00/12/12/12/00/12/12/12/00/12/00/12/12/12/00/12/00/12/00/12/12/00/12/12/12/00/12/12/12/
12/00/12/00/12/00/00/00/00/12/00/00/00/00/00/00/00/00/12/00/12/00/00/00/00/00/12/00/00/00/00/00/00/12/12/00/00/00/12/12/
12/12/12/00/12/12/12/12/00/12/12/12/12/00/12/00/12/00/00/00/12/12/00/12/00/12/12/12/12/12/12/12/00/12/00/00/12/00/00/12/
12/00/12/00/12/00/00/12/00/00/12/00/12/00/12/12/12/00/12/00/12/00/00/00/00/00/00/12/00/12/00/00/00/00/00/12/12/12/00/12/
12/00/12/00/12/00/12/12/00/12/12/00/00/00/00/12/00/00/12/00/12/12/12/12/00/12/00/12/00/00/00/12/00/12/00/00/00/00/00/12/
12/00/00/00/00/00/00/12/00/12/00/00/12/12/12/12/00/12/12/12/12/00/00/12/12/12/00/00/00/12/12/12/00/12/00/12/12/12/00/12/
12/12/12/00/12/12/00/12/00/12/00/12/12/00/00/12/00/12/00/00/00/00/12/12/00/00/00/12/00/12/00/12/00/12/00/00/12/00/00/12/
12/00/12/12/12/00/00/12/00/12/00/00/00/00/12/12/00/12/00/12/12/00/12/00/00/12/00/12/00/12/00/00/00/12/12/00/12/00/12/12/
12/00/00/12/00/00/12/12/00/12/12/12/12/00/12/00/00/12/00/00/12/00/12/12/12/12/00/12/12/12/00/12/12/12/00/00/12/00/00/12/
12/12/00/00/00/12/12/00/00/00/12/00/12/00/12/12/12/12/12/00/12/00/00/00/00/00/00/00/00/00/00/12/00/12/00/12/12/12/00/12/
12/00/00/12/00/00/00/00/12/00/12/00/00/00/12/00/00/00/12/00/12/12/12/12/00/12/12/12/12/12/00/12/00/00/00/00/00/00/00/12/
12/00/12/12/12/12/12/12/12/12/12/12/12/00/12/00/12/00/12/00/00/12/00/12/12/12/00/12/00/12/00/00/00/12/12/12/12/12/12/12/
12/00/12/00/12/00/12/00/12/00/00/00/12/00/12/00/12/00/12/12/00/12/00/00/00/12/00/12/00/12/00/12/00/12/00/12/00/00/00/12/
12/00/12/00/12/00/12/00/00/00/12/00/12/00/12/00/12/00/00/00/00/12/00/12/00/00/00/12/00/12/00/12/00/12/00/12/00/12/00/12/
12/00/00/00/00/00/12/00/12/12/12/00/12/00/12/12/12/12/12/00/12/12/00/12/12/00/12/12/00/00/00/12/00/00/00/00/00/12/00/12/
12/12/12/00/12/00/00/00/12/00/00/00/00/00/00/00/00/00/12/00/12/00/00/12/00/00/00/00/00/12/00/12/00/12/00/12/12/12/00/12/
12/00/12/00/12/12/12/00/12/00/12/12/12/12/12/00/12/00/12/00/12/12/00/12/12/00/12/12/00/12/00/00/00/12/00/00/00/00/00/12/
12/00/00/00/00/12/00/00/12/00/00/00/12/00/12/00/12/00/00/00/12/00/00/00/00/00/00/12/00/12/00/12/00/12/00/12/12/12/00/12/
12/00/12/12/12/12/00/12/12/00/12/00/12/00/12/00/12/00/12/00/12/00/12/12/12/12/00/12/12/12/00/12/00/12/00/12/00/12/00/12/
12/00/00/00/00/00/00/00/00/00/12/00/00/00/00/00/12/00/00/00/12/00/00/00/00/00/00/00/00/12/00/00/00/12/00/00/00/12/00/12/
12/12/12/12/12/12/12/12/12/12/12/12/12/12/12/12/12/12/12/12/12/12/12/12/12/12/12/12/12/12/12/12/12/12/12/12/12/12/12/12/