7
12/20/
1/1/
1/39/
23/1/
23/39/
1/20/
23/20/
12/12/12/12/12/12/12/12/12/12/12/12/12/12/12/12/12/12/12/12/12/12/12/12/12/12/12/12/12/12/12/12/12/12/12/12/12/12/12/12/
12/00/12/00/12/00/00/00/00/00/12/00/00/00/00/00/00/00/00/00/00/00/12/00/12/00/00/00/00/00/00/00/00/00/12/00/12/00/00/12/
12/00/00/00/12/00/12/12/12/00/12/00/12/12/12/12/12/12/12/12/12/00/12/00/12/00/12/12/12/12/12/12/12/00/00/00/12/00/12/12/
12/12/12/00/12/00/00/12/00/00/12/00/00/00/12/00/00/00/12/00/00/00/00/00/12/00/00/00/00/00/00/00/00/00/12/00/12/00/00/12/
12/00/12/00/00/00/12/12/00/12/12/00/12/00/00/00/12/00/00/00/12/00/12/00/12/12/12/12/12/00/12/12/12/12/12/00/12/12/00/12/
12/00/12/00/12/12/12/12/00/00/00/00/12/12/12/12/12/12/12/12/12/00/12/00/00/00/00/00/00/00/00/00/00/00/00/00/00/00/00/12/
12/00/12/00/12/00/00/12/12/00/12/00/12/00/00/00/12/00/00/00/12/00/12/00/12/12/12/12/12/00/12/12/12/12/12/00/12/12/00/12/
12/00/12/00/00/00/00/00/00/00/12/00/00/00/12/00/00/00/12/00/00/00/00/00/12/00/00/00/00/00/00/00/00/00/12/00/12/00/00/12/
12/00/00/00/12/12/00/12/00/12/12/00/12/12/12/12/12/12/12/12/12/00/12/00/12/00/12/12/12/12/12/12/12/00/00/00/12/00/12/12/
12/00/12/00/00/12/00/12/00/00/12/00/00/00/00/00/00/00/00/00/00/00/12/00/12/00/00/00/00/00/00/00/00/00/12/00/12/00/00/12/
12/00/12/12/12/12/00/12/00/12/12/12/12/12/00/12/00/12/12/12/12/12/12/00/12/12/12/12/12/12/12/12/12/12/12/00/12/12/12/12/
12/00/12/00/00/00/00/00/00/00/00/00/00/12/00/12/12/12/00/00/12/00/00/00/00/00/12/00/00/00/00/12/00/00/00/00/00/00/00/12/
12/00/00/00/12/12/12/12/12/12/12/12/00/00/00/00/00/12/12/00/00/00/12/00/12/00/00/00/12/00/12/12/00/12/12/12/12/12/00/12/
12/12/12/00/00/00/00/00/00/00/00/00/00/12/00/12/00/00/12/12/12/12/12/12/12/12/12/12/12/00/00/12/00/00/00/12/00/00/00/12/
12/00/12/12/12/12/12/12/00/12/12/12/12/12/00/12/12/00/00/12/00/00/00/12/12/00/00/00/12/00/12/12/12/12/00/12/00/12/12/12/
12/00/12/00/00/00/00/12/00/00/00/00/12/00/00/00/12/12/00/12/12/12/00/00/00/00/12/00/00/00/00/12/00/00/00/12/00/00/00/12/
12/00/00/00/12/12/00/12/00/12/12/00/00/00/00/00/00/00/00/00/00/12/12/12/12/12/12/12/12/12/12/12/00/12/00/12/00/12/00/12/
12/00/12/00/00/12/00/00/00/12/00/00/12/00/00/00/12/12/00/12/00/00/00/12/00/00/00/00/00/00/00/00/00/12/00/00/00/12/00/12/
12/00/12/12/12/12/12/00/12/12/12/12/12/12/00/12/12/00/00/12/12/12/00/12/12/12/12/00/12/12/12/12/00/12/00/12/00/12/00/12/
12/00/12/00/00/00/00/00/00/00/00/00/00/12/00/12/00/00/00/00/00/12/00/12/00/00/00/00/00/00/00/12/00/00/00/12/00/00/00/12/
12/00/00/00/12/12/12/12/12/12/12/12/00/00/00/00/00/12/12/12/00/00/00/00/00/12/12/12/12/12/00/12/12/12/00/12/00/12/12/12/
12/00/12/00/00/00/00/00/00/00/00/00/00/12/00/12/00/00/00/00/00/12/00/12/00/00/00/12/00/00/00/12/00/00/00/12/00/00/00/12/
12/00/12/12/12/12/12/12/12/12/12/12/12/12/00/12/12/12/12/12/12/12/00/12/12/00/12/12/12/00/12/12/00/12/12/12/12/12/00/12/
12/00/00/00/00/00/00/00/00/00/00/00/00/00/00/12/00/00/00/00/00/00/00/12/00/00/00/00/00/00/00/12/00/00/00/00/00/00/00/12/
12/12/12/12/12/12/12/12/12/12/12/12/12/12/12/12/12/12/12/12/12/12/12/12/12/12/12/12/12/12/12/12/12/12/12/12/12/12/12/12/